[
    {
        "16:33:26": "on"
    },
    {
        "16:33:27": "on"
    },
    {
        "16:33:28": "on"
    },
    {
        "16:33:29": "on"
    },
    {
        "16:33:30": "on"
    },
    {
        "16:33:31": "on"
    },
    {
        "16:33:32": "on"
    },
    {
        "16:33:33": "on"
    },
    {
        "16:33:34": "on"
    }
]